R 975 975
NO ./texture/bluestone.xpm
SO ./texture/greystone.xpm
WE ./texture/redbrick.xpm
EA ./texture/wood.xpm
S ./texture/pillar.xpm
C 148,86,248
F 94,138,28

111111111111111
100000000000101
100001000000101
111100000010101
100000000010101
100000001111101
1000000000000001
100000000000001
1111110N0111101
100000000000001
111111111111111
111111111111111
111111111111111
100000000000001
111111111111111