R 800 600
NO      ./texture/3.xpm

WE ./texture/8.xpm
EA ./texture/2.xpm
SO ./texture/7.xpm
F 95, 80, 50
C 0,0,50



  11111111  1111111111111111
  10000001111000001000000001
  10000000000000001000000001
  1000000111100000100000000111111111
  11111111  100000100000000000000001
            100000100000000100000001
111111111111100011111110000100000001
100000000000000000000000000111111001
100000010000000000000000000000001001
100000010000100000000000000000001001
100000010000111100111100000000001001
1000111111111  1001  100000000000001
10001          1001  111111011111111
10001          1001       101
10001111111111110011111111101111111
10001000000000000000000000000000001
1000000000000000000000000000000W001
11111111111111111111111111111111111
